name=level 01
diamonds=16
time=200
start=1,13
height=14
width=45
TTTTTTTTTTTTTTTTTTTTTTTTTTTTTTTTTTTTTTTTTTTTT
TWEEEEEEEEEEEEEWEEEEEEEEEEEEEEEEEEEEEEEEEEEWT
TWRREEEEEEDDDDDWEEEEEEEEEEEEEEEEEEEEEEEEEEEWT
TWERRREEEEDDDDDWEEEEEEEEEEEEEEEEEEEEEEEEEEEWT
TWEEEEEEEEEEEEEWEEEEEEEEEEEEEEEEEEEEEEEEEEEWT
TWEEEEEEEEEEEEEWEEEEEEEEEEEEEEEEEEEEEDEEDEEWT
TWEEEEEEEEEEEEEWEEEEEEEEEEEEEEEEEEEEEEDEEEEWT
TWEEEEEEEEEEEEEWEEEERDEEEEEEEEEEEEEEEEEEEEEWT
TWEEEEEEEEEEEEEEEEEESSSSSSSSEEEEEEEEEEEEEEEWT
TWEEEEEEEEEEEEEEEEEESSSSSSSSEEEEEEEEEEEEEEEWT
TWEEEEEEEEEEEEEWEEEESSSSSSSSEEEEEEEEEEEEEEEWT
TWEEEEEEEEEEEEEWEEEEEEEEEEEEEEEEEEDDDXEEEEEWT
TWWWWWWWWWWWWWWWWWWWWWWWWWWWWWWWWWWWWWWWWWWWT
TTTTTTTTTTTTTTTTTTTTTTTTTTTTTTTTTTTTTTTTTTTTT